##########
## ! #####
##    ####
##    ####
#### #####
##  $  ###
##  @ !###
##  $  ###
####  ####
##########
