##########
## . #####
##    ####
##    ####
###   ####
##  $  ###
##  @ .###
##  $  ###
#### $ ####
##########
