##########
##########
##.    ###
####   ###
##    ####
##  $  ###
## #   ###
##.#   ###
#### @ ###
##########
