##########
# .#   .##
## #  ####
##  $ ####
## $   $ #
##    .  #
#####  ###
##@ # $###
##   . ###
##########
