##########
##     .##
##   # ###
###$ # ###
### .# ###
#.  ## ###
#  $ #  ##
#    $! ##
###@ #  ##
##########
