##########
##########
##.    ###
####   ###
##    ####
## @   ###
## #   ###
##!#   ###
####   ###
##########
5