##########
# !#   !##
## #  ####
##    ####
##       #
##    .  #
##### @###
##  # $###
##   ! ###
##########
3