##########
# ! #$ .##
## ## ####
##   @####
##    ####
##    !###
#####  ###
##  #  ###
##     ###
##########
3