##########
## . #####
##    ####
##   $####
###   ####
##. $  ###
##     ###
##@ $  ###
#### . ###
##########
2