##########
# !#  @!##
## #  ####
##    ####
##    ####
##    !###
#####  ###
##  #  ###
##     ###
##########
3