##########
## ! #####
##    ####
##    ####
###   ####
##     ###
##    !###
##    @###
####$  ###
##########
2