##########
##   ##.##
## $    ##
##    $ ##
####    ##
##.     ##
#### #$###
##@    ###
#.     ###
##########
4