##########
## ! #####
## @  ####
##    ####
#### #####
##     ###
##    .###
##  $  ###
####  ####
##########
1