##########
##   ##.##
## $    ##
##      ##
####  $ ##
##.   $ ##
######@###
##     ###
#.     ###
##########
4