##########
## . #####
##    ####
##    ####
#### #####
##  $  ###
##  @ .###
##  $  ###
####  ####
##########
1