##########
## . #####
##    ####
##    ####
#### #####
## $   ###
##  $@.###
##     ###
####  ####
##########
1